Scaffold	Position	Ref_Allele_Count	Alt_Allele_Count	Coverage_Depth	Alt_Allele_Frequency
1	3	25	79	104	0.759615385
1	15	93	93	186	0.5
1	78	10	34	44	0.772727273
1	90	8	12	20	0.6
2	11	48	30	78	0.384615385
2	23	60	65	125	0.52
2	44	76	59	135	0.437037037
3	5	81	5	86	0.058139535
3	24	65	89	154	0.577922078
3	78	96	51	147	0.346938776
4	1	93	93	186	0.5