Scaffold	Position	Ref_Allele_Count	Alt_Allele_Count	Coverage_Depth	Alt_Allele_Frequency
1	3	48	82	130	0.630769231
1	15	64	7	71	0.098591549
1	78	50	29	79	0.367088608
2	11	74	76	150	0.506666667
2	23	76	76	152	0.5
2	44	37	43	80	0.5375
3	5	20	28	48	0.583333333
3	24	48	72	120	0.6
3	38	37	72	109	0.660550459
3	78	85	21	106	0.198113208
4	1	42	53	95	0.557894737
4	5	21	70	91	0.769230769