Scaffold	Position	Ref_Allele_Count	Alt_Allele_Count	Coverage_Depth	Alt_Allele_Frequency
1	3	73	161	234	0.688034188
1	15	157	100	257	0.389105058
1	78	60	63	123	0.512195122
1	90	8	12	20	0.6
2	11	122	106	228	0.464912281
2	23	136	141	277	0.509025271
2	44	113	102	215	0.474418605
3	5	101	33	134	0.246268657
3	24	113	161	274	0.587591241
3	38	37	72	109	0.660550459
3	78	181	72	253	0.28458498
4	1	135	146	281	0.519572954
4	5	21	70	91	0.769230769