Scaffold	Position	Ref_Allele_Count	Alt_Allele_Count	Coverage_Depth	Alt_Allele_Frequency
1	11	14	115	129	0.891472868
1	16	30	185	215	0.860465116
2	9	88	119	207	0.574879227
2	12	98	124	222	0.558558559
2	67	95	194	289	0.671280277
3	8	0	0	0	0
4	99	118	54	172	0.313953488
4	101	132	49	181	0.270718232
4	115	166	42	208	0.201923077
5	6	126	100	226	0.442477876
5	19	112	114	226	0.504424779